XXXXXXXXXXXXXNXXXXX
X00000000000000000X
X00000000000000000X
X00000000000000000X
X00000000000000000X
X00000000000000000X
XXXXXXXXXXXXXXXXXXX