XXXXXXXNXXXXXXX
X0000000000000X
W0000000000000X
X0000000000000X
X1111111111111X
X111111XXXX111X
X1111111T11111X
XXXXXXXXXXXXXXX