XXXXXXXNXXXXXXXX
X11111000001110X
X1X1X0000001110X
X1X11X000000110E
X1X11X000001110X
X1X1XR0X0000011X
XT111X000000000X
XXSXXXXXXXXXXXXX