XXXXXXXXXNXXXXXXXXX
X00000000000000000X
X000P000111000P000X
X00000011111000000X
X00000111111100000X
X00001111111110000X
X00011111111111000X
X00111111111111100X
X01111111111111110X
X11111111111111111X
XXXXXXXXX0XXXXXXXXX
X11111111111111111X
X01111111111111110X
X00111111111111100X
X00011111111111000X
X00001111111110000X
X00000111111100000X
X00000011111000000X
X00RRR0011100RRR00X
X00000000000000000X
XXXXXXXXXSXXXXXXXXX