XXXNXXXXXXXXXXXXXXXXXXXXX
X0000000011111X111111XXTX
X00000000XXXX1X1XXXX1XX1X
X00000000XTXX111XXX11XX1X
X1XXXXXXXX111XX1XXP1XXX1X
X11111X11111XX111XX1XXX1X
X1X11XX1XXXXX11X1111XXX1X
X1XX11X1X11111XXXXX1XXX1X
X1XXX111XXXXXXXX11111XX1X
X1XXXX1XXXXXXXXXX1XXXXX1X
X1XX111XXXXP111111111111X
X1XXX111111XXXXXXXXXXXXXX
X1XXX1XXXX1X111111111111X
X1XXX1XXXX1111XXXXXXXXX1X
X1XTX11111XXXX11111XXTTPX
X111XXXXX111111XXXPXXTRRX
XXXXXXXXXXXXXXXXXXXXXXXXX