XXNXXXXXXXXXXXXXXXXXX
X00000000011X000011XX
XXXX0000000001111000X
XX00000XXXXX00000000X
XXX000000PXXX000000EX
XXXXX00XXXXXXX1111XXX
XXX100011111111111XXX
X111000011111111111XX
X1111000001111111111X
XXXXXXXXXXXXSXXXXXXXX