XXXXXNXXXXX
X000000000X
X000000000X
X0000C0000X
X000000000X
W000000000X
XXXXXXXXXXX