XXXXXXXXXXXXX
XXXXXXNXXXXXX
X00000000000X
X00000000000X
X00000000000X
X00000C00000X
X00000000000X
XXXXXXXXXXXXX