XXXXXXNXXXXXX
X00000000000X
X00000000000X
W00000C00000E
X00000000000X
X00000000000X
XXXXXXSXXXXXX