XXXXXXX             XXXXXXXX
X000000XXXXXXXXXXXXX0000000X
X00000000000000000000000000X
X00000000000000000000000000X
X000000000000C0000000000000X
XXXXXXXXXXXXXXXXXXXXXXXXXXXX