LHHHHHHHHHHHHHR
VGGGGGGGGGGGGGV
VGGGGGGGGGGGGGV
VGGGGGGGGGGGGGV
VGGGSGGGPGGGGGV
VGGGGGGGGGGGGGV
VGGGGGGGGGGGGGV
lHHHHHHHHHHHHHr