XXXXXXXXXXXXXXXXXXX
X00000000000000000X
X00000000000000000X
X00000000000000000X
X000000000C0000000X
XXXXXXXXXXXXXXXXXXX