XXXXXXXXXXXXXXX
X0000000000000X
X0000000000000X
X0000000000000X
X0000000000000X
X0000000000000X
X0000000000000X
X0000000000000X
X0000000000000X
X0000000000000X
X0000000C00000X
XXXXXXXXXXXXXXX