XXXEXXX
X00000X
X00C00X
X00000X
XXXXXXX