LHHHHNHHHHJ
V000000000V
V000000000V
V0000C0000V
V000000000V
V000000000V
JHHHHHHHHHL