XXXXXNXXXXX
X000000000X
X000000000X
X0000C0011X
X000011111X
X011111111X
XXXXXXXXXXX