LHHHHHHHHHHHHHJ
VLHHHHHNHHHHHJV
VV00000000000VV
VV00000000000VV
VV00000000000VV
VV00000C00000VV
VV00000000000VV
VlHHHHSHHHHHHjV
lHHHHHHHHHHHHHj