XXXXXXXXXXXXX
XXXXXXNXXXXXX
X00001110000X
X00011111000X
X00000000000X
X00000C00000X
X00000000000X
XXXXXXXXXXXXX