LHHHHHHHHHHHJ
VLHHHHNHHHHJV
V00000000000V
V00000000000V
V00000000000V
V00000C00000V
V00000000000V
JHHHHHSHHHHHL