XXXXXXNXXXXXX
X00000000000X
X00000000000X
N00000C00000N
X00000000000X
X00000000000X
XXXXXXNXXXXXX