LHHHHHNHHHHHJ
V00000000000V
V00000000000V
W00000C00000E
V00000000000V
V00000000000V
JHHHHHSHHHHHL