XXXXXXNXXXXXX
X00001000000X
X01110100100X
N01000C00100N
X01100000100X
X00000110000X
XXXXXXNXXXXXX