XXXXXXXXXXXXXXXXXXXXXXXXXXXXXXXXXX
X00000000000000000000000000000000X
X00000000000000000000000000000000X
X00000000000000000000000000000000X
X00000000000000000000000000000000X
X0000000000000000C000000000000000X
X00000000000000000000000000000000X
X00000000000000000000000000000000X
X00000000000000000000000000000000X
X00000000000000000000000000000000X
X00000000000000000000000000000000X
XXXXXXXXXXXXXXXXXXXXXXXXXXXXXXXXXX