LHHHHHHHHHHHHHHHHHHHHHHHHHHHHHHHHJ
V00000000000000000000000000000000V
V00000000000000000000000000000000V
V00000000000000000000000000000000V
V00000000000000000000000000000000V
V0000000000000000C000000000000000V
V00000000000000000000000000000000V
V00000000000000000000000000000000V
V00000000000000000000000000000000V
V00000000000000000000000000000000V
V00000000000000000000000000000000V
lHHHHHHHHHHHHHHSHHHHHHHHHHHHHHHHHj