XXNXXXXXXXXX
XX0XXXXXXX0E
XX0XXXXXXX0X
XX0XXXXXXX0X
XX00XXXXXX0X
XX0XXXXXXX0X
XX0XXXXXX00X
XX00000000XX
XXXXX0XXXXXX
XXXXX0XXXXXX
XXXXX0XXXXXX
XXXXXSXXXXXX