XXXXXXXXXXXXXXX
X111111XXX1111X
X11XXX1XXX1XX1X
X11X1X11111XX1X
X11X1X11XXXXX1X
X11X1XXXX11111X
X11X1100000111X
XXXXXXXXSXXXXXX