XXXXXXXXXXXX
XXXXXXNXX0XX
XXXXX000000X
XXXXXXX0000X
XXSXXXX0000E
XX000000000X
X00000P0000X
XXXXXXXXSXXX