XXXXXXXXXXXXXXXXXXXXXXXXXXXX
X1111111XX1111111111111111XX
X1XXXXX1111XXXXXXX1XXXXXXXXX
X11XXXXX11X1111XX11XXX1111PX
XX0XXXXXX111XXXXX11XXX1XX1XX
X00000XXXX1XXX1111XX111XX11X
X00000X1111XP11X1111111XX1XX
X00000X1XX11XXXXX1XXXXXXX1XX
X0000011XXX11111X1XXXXXXX1TX
X00000XXXXX111XXX111111TXXTX
XXXSXXXXXXXXXXXXXXXXXXXXXXXX