XXXXXXXXXXXX
XX000TT000XX
XXXX0000XXXX
XXXX1111XXXX
XXXX1111XXXX
XXXX0000XXXX
XXXX0000XXXX
XXXX0000XXXX
XX00000000XX
XXXXXSXXXXXX