XXXXXXXXXXXXXX
XXX1111T1111TX
XXW1111111111X
XXX1111111111X
XXXXXXXXXX111X
XXXXXX000000XX
XP00000000000X
XXX0000000000X
XXXXXXSXXXXXXX