XXXXXXXNXXXXXXXXXXXXXXXXXXXX
X11100000000000011111110000X
X11100000000000000111110000X
W11100000000R00000011110000E
X11111000000000000001110000X
X00111110000000000011110000X
XT0001111111000001111110000X
XXXXXXXXSXXXXXXXXXXXXXXXXXXX