XXXXXXXXXXXXXXXXXXXXXXXXXXXXXXXXXXXXXXXXXXXXXXXX
XR000111111X1111X1111X1XX111111111110000XXXXXXXX
XT0001111X111X11X1XX1X111XXXXXXX11X100000000000X
XTP001111XXXXX11X1XX1XRX1111111111X100000000000E
XTP001111X11X11111XX1XXXXXXXXX1111X100000000000X
XRP001111X1XXXXX1XX11111111111111X11000000XXXXXX
XR0001111X11111111XXXX11111111XXXXXX0000000000XX
XXXXXXXXXXXXXXXXXXXXXXXXXXXXXXXXXXXXXXXXXXXXXXXX