XXXXXXNXXXXXXXXXXXX
XXX110000000000XXRX
XX1111000000000000X
X000XX000000000XX0X
X000XX000000000XX0X
XP0011100000000000E
XXXXXXXXXXXXXXXXXXX