XXXXXXXNXXXXXXXXXXX
X00111100000011110X
X00000111100111100X
W00111100111100000E
X00010000001100000X
X00010000111100000X
XP0010011111100T00X
XXXXXXXXSXXXXXXXXXX