XXXXXXXNXXXXXXX
X0000000000000X
X0000000000000X
W0000000000000E
X0000000000000X
X0000000000000X
X0000000000000X
XXXXXXXXSXXXXXX