XXXXXXNXXXXXXX
X0R0XX0001111X
X011X0000XXX0X
X0X0000XXX000X
XX000000XXX00E
XXPXX0001111XX
XXXXXXXXXXXXXX