XXXXXXNXXXXXXXXXXXX
X00000000000000000X
X00000100000000XXXX
XXXX1111111XXXXXEXX
X1111111111111XX00X
XT0000000000111111X
XXXXXXXXXXXXXXXXXXX