XXXXXXXXXXXXXXX
X000000TT00000X
X000R00000P000X
X0000000000000X
XXXXXXXXSXXXXXX