XXXXXXXNXXXX
XXXXXX11100X
XXXXXXXX111E
XXXXXXX111XX
XXXX1111XXXX
X0000011111X
XXXX00000XXX
X0000000000X
X0000000000X
XXXXXSXXXXXX