XXXXXXXNXXXXXXX
X0000000000000X
X000000R000000X
X00000RRR00000X
X000000R000000X
X0000000000000X
X0000000000000X
XXXXXXXSXXXXXXX