XXXXXXXNXXXXXXX
X0000000000000X
X0000011000000X
W0000011000000E
X1110001111111X
X1110001111111X
X111000001111PX
XXXXXXXXSXXXXXX