XXXXXXXXXXXXXXXXXXXXXXXXXXXXXXXXXXXXXXXXXX
X0000000000000000000000000000000000000000X
X0000000000000000000000000000000000000000X
X000000000000000000000000000000R000000000X
X0000001111100000000000000111110000000000X
X0001111R111100R0000000011111111100000000X
X0011111111100000000000000111110000000000X
X0000000000000000000000000000000000000000X
X0000000000000000000000000000000000000000X
X0000000000000000000000001111000000000000E
N0000000000000000000000001111000000000000X
X0000000000000000000000000000R00000000000X
X1111100000000000000000000000000000000000X
X0111100000011111111111111100000000000000X
X111110000011111R11111100000000R000000000X
X0000000000111110111110000000000000000000X
X0000000000001110111111110000000000000000X
X0000000000011110000000000000000000000000X
X000000000000001111111100000000000R000000X
XXXXXXXXNXXXXXXXXXXXXXXXXXXXXXXXXXXXXXXXXX