XXXXXXXXXXXXXXXX
X11111111111111X
X11111111111111X
X00000011111111X
X00000000000000E
X11111111111111X
XXXXXXXXNXXXXXXX