XXXXXXXNXXXXXXX
X1111000000000X
X1111100000000X
XT111100000000X
XP111000000000X
X1111000000000E
X1100000000000X
XXXXXXXSXXXXXXX