XXXXXXXXXXXXXXXXXNXXXXXXXXXXXXXXX
X0000000000000000000000000000000X
W0000000000000000P00000000000000E
X1111111111111111111111111111111X
X1111111111111111111111111111111X
X1111111111111111111111111111111X
X1111111111111111111111111111111X
X111T11111111111T111111111111T11X
XXXXXXXXXXXXXXXXXXXXXXXXXXXXXXXXX