XXXXXXXXXXXXXXXXXXXXX
XXXXXXXXXXXXXXXXX00PX
XXXXXXXXXXXXXX000000X
XX000000001110000000X
XW000000001R10000000E
XX000000001110000000X
XXXXXXXXXXXXXX000000X
XXXXXXXXXXXXXXXXX000X
XXXXXXXXXXXXXXXXXXXXX