XXXXXXXXXXXXXXX
X1111111111111X
X1111111110000X
X000011111110EX
X000000111100XX
W000000000000XX
X0000011111000X
X0000111111000X
X0000000111000X
XXXXXXXSXXXXXXX