XXXXXXXXXXXXXXXXXX
X00000000RTR00000X
X0111111111111110X
X0011111111111100X
XX00111111111100XX
XXX011111111110XXX
XXXX0111111110XXXX
XXXXX01111110XXXXX
XXXXXX000000XXXXXX
XXXXXXW0000EXXXXXX
XXXXXX000000XXXXXX
XXXXX01111110XXXXX
XXXX0111111110XXXX
XXX011111111110XXX
XX00111111111100XX
X0011111111111100X
X0111111111111110X
X0000000RTR000000X
XXXXXXXXXXXXXXXXXX